0000000000000000
0000000000000000
0000000000000000
1111100000000000
0000100000000000
0000101000000000
0000110000000000
0000011111100000
0000000000000000
0000000000000000
0000000000000000
0000000000000000
0000000000000000
0000020000000000
0000000020000000
0000000000000000
