0000000000000000
0000000111100000
0000000000000000
0000000000000000
0000000000000000
0000111111100000
0000000000000000
0000011100000000
0000000000000000
0000000000000000
0000000000000000
0000000000000000
0000000000000000
0000000000000000
0000000000000000
0000000000000000
