0000000000000000000000
0200000000000000000000
0000000000000000111111
0000000000000000111111
0000000000000000111111
0200000010000000111111
0000000000000000111111
0000000000000000111111
0200000001000000111111
0000000000000000000000
0000000000000000000000
0000000000000000000000
0000000000000000000000
0000000000000000000000
0000000000000000000000
0000000000000000000000
0000000000000000000000
0000000000000000000000
0000000000000000000000
0000000000000000000000
0000000000000000000000
0000000000000000000000
0000000000000000000000
0000000000000000000000
0000000000000000000000
0000000000000000000000
0000000000000000000000
0000000000000000000000
0000000000000000000000