111111111111111111111111111111111111111111111111
100000000000000000000001100000000000000000000001
100000000000000000000001100000000000000000000001
100000000000000000000001100000000000000000000001
100000000011000000000001100000000011000000000001
100000000011000000000001100000000011000000000001
100000000000000000000001100000000000000000000001
100000000000000000000001100000000000000000000001
100000000000000000000001100000000000000000000001
100000000000000000000001100000000000000000000001
111111111111111111111111111111111111111111111111
100000000000000000000001100000000000000000000001
100000000000000000000001101111111111111000000001
100000000000000000000001100000000000000000000001
100000000011000000000001100000000011000000000001
100000000011000000000001100000000011000000000001
100000000000000000000001100000000000000000000001
100000000000000000000001100000000000000000000001
100000000000000000000001100000000000000000000001
100000000000000000000001100000000000000000000001
111111111111111111111111111111111111111111111111
