00000000010000000000
00000000010000000000
02000000000000111000
00000000000000001000
00001100000000001000
00000000010000001000
02000000000000000000
00000000000000000000
00000000010000000000
00000000010001000000
00000000000001000000
00000000000001000000
00000000000001000000
00000000001111111100
00000000000000000000
02000000000000000000
00000000010000000000
00000000010000000000
00111100010000000000
00000000010000000000