0000000001
0200000011
0000000001
0200000001
0000000001
0000001111
0010000111
0000000101
0200000101
1000001001